Reminiscing	Sarah and the Sundays	Sarah-and-the-Sundays-Reminiscing
Expectations	MAGIC!	MAGIC-Expectations
Golden	Cory Wong	Cory-Wong-Golden
Trampoline	Kero Kero Bonito	Kero-Kero-Bonito-Trampoline
Algorhythm	Childish Gambino	Childish-Gambino-Algorhythm
Human Convention	The Reign of Kindo	The-Reign-of-Kindo-Human-Convention
Impossible World	The Reign of Kindo	The-Reign-of-Kindo-Impossible-World
Lucie, Too	Now, Now	Now-Now-Lucie-Too
Darth Binks	Andrés	Andres-Darth-Binks
Mr. Invisible	Thank You Scientist	Thank-You-Scientist-Mr-Invisible
Don't Forget About Me	Noname	Noname-Dont-Forget-About-Me
Désolé	Rejjie Snow	Rejjie-Snow-Desole
Glory	Hodgy	Hodgy-Glory
Soulfood	redveil	redveil-Soulfood
Voilà	N.E.R.D	NERD-Voila
Coolin'	Mýa	Mya-Coolin
Ups and Downs	David Mann	David-Mann-Ups-and-Downs
Mood	The Internet	The-Internet-Mood
Everytime	Paul Mccall	Paul-Mccall-Everytime
I Been	Berhana	Berhana-I-Been
Psychologa!!!	Happysad	Happysad-Psychologa
POLSKIE TANGO	Taco Hemingway	Taco-Hemingway-POLSKIE-TANGO
Bal wszystkich świętych	Budka Suflera	Budka-Suflera-Bal-wszystkich-swietych
Kup sobie psa	Piotr Bukartyk	Piotr-Bukartyk-Kup-sobie-psa
Łydka	Happysad	Happysad-Lydka
Wystarczę ja	Paweł Domagała	Pawel-Domagala-Wystarcze-ja
Trofea	Dawid Podsiadło	Dawid-Podsiadlo-Trofea
Dlugosc Dzwieku Samotnosci	Myslovitz	Myslovitz-Dlugosc-Dzwieku-Samotnosci
W piwnicy u dziadka	Happysad	Happysad-W-piwnicy-u-dziadka
Urke	Wilki	Wilki-Urke
Ostatnia Nocka - 2014 Remastered	Yugopolis	Yugopolis-Ostatnia-Nocka
Mieć czy być	Myslovitz	Myslovitz-Miec-czy-byc
Miasto budzi się (feat. Paweł Kukiz)	Yugopolis	Yugopolis-Miasto-budzi-sie
Bohema	Wilki	Wilki-Bohema
Czysty jak łza	Happysad	Happysad-Czysty-jak-lza
Na zawsze i na wieczno??	Wilki	Wilki-Na-zawsze-i-na-wieczno
z tobą / DO DOMU	KRÓL	KROL-z-toba-DO-DOMU
Hej wy	Kortez	Kortez-Hej-wy
Nadzy na mróz	Happysad	Happysad-Nadzy-na-mroz
Warszawa	T.Love	TLove-Warszawa
Pola	Muniek Staszczyk	Muniek-Staszczyk-Pola
Symetryczno-Liryczna	Enej	Enej-Symetryczno-Liryczna
O Pani!	Grzegorz Hyzy	Grzegorz-Hyzy-O-Pani
Melodia	sanah	sanah-Melodia
Wiosna	Organek	Organek-Wiosna
Kryzysowa Narzeczona	Lady Pank	Lady-Pank-Kryzysowa-Narzeczona
Wehikuł Czasu - To Byłby Cud - 2003 Remaster	Dzem	Dzem-Wehikul-Czasu
Z Twarza Marlin Monroe	Myslovitz	Myslovitz-Z-Twarza-Marlin-Monroe
Oprócz błękitnego nieba	Golden Life	Golden-Life-Oprocz-blekitnego-nieba
Chcemy Być Sobą	Perfect	Perfect-Chcemy-Byc-Soba
Tak ... Tak ... To Ja	Obywatel G.C	Obywatel-GC-Tak-Tak-To-Ja
King - 2008 Remaster	T.Love	TLove-King
Dzieci wybiegły - 2014	Elektryczne Gitary	Elektryczne-Gitary-Dzieci-wybiegly
Kocham Cię jak Irlandię	Kobranocka	Kobranocka-Kocham-Cie-jak-Irlandie
Mój Jest Ten Kawałek Podłogi	Mr. Zoob	Mr-Zoob-Moj-Jest-Ten-Kawalek-Podlogi
Kocham Wolność	Chłopcy Z Placu Broni	Chlopcy-Z-Placu-Broni-Kocham-Wolnosc
Szklana Pogoda	Lombard	Lombard-Szklana-Pogoda
Cykady na Cykladach - 2011 Remaster	Maanam	Maanam-Cykady-na-Cykladach
Arahja	Kult	Kult-Arahja
Ezoteryczny Poznań	Pidżama Porno	Pidzama-Porno-Ezoteryczny-Poznan
Zazdrosc	Hey	Hey-Zazdrosc
Za Ostatni Grosz	Budka Suflera	Budka-Suflera-Za-Ostatni-Grosz
Biała armia	Bajm	Bajm-Biala-armia
Whisky - 2003 Remaster	Dzem	Dzem-Whisky
Celina	Kazik Na Żywo	Kazik-Na-Zywo-Celina
Nadzieja	IRA	IRA-Nadzieja
Mniej Niż Zero	Lady Pank	Lady-Pank-Mniej-Niz-Zero
Chlopcy	Myslovitz	Myslovitz-Chlopcy
Berlin Zachodni 2011	Big Cyc	Big-Cyc-Berlin-Zachodni-2011
Ale Wkoło Jest Wesoło	Perfect	Perfect-Ale-Wkolo-Jest-Wesolo
Kiedy byłem małym chłopcem	Breakout	Breakout-Kiedy-bylem-malym-chlopcem
Mówię Ci, Że	Tilt	Tilt-Mowie-Ci-Ze
Mamona	Republika	Republika-Mamona
Teksanski	Hey	Hey-Teksanski
O Sobie Samym	Robert Gawlinski	Robert-Gawlinski-O-Sobie-Samym
Szare miraże	Maanam	Maanam-Szare-miraze
Tolerancja / Na Miły Bóg	Stanisław Soyka	Stanislaw-Soyka-Tolerancja-Na-Mily-Bog
Zamki na Piasku	Lady Pank	Lady-Pank-Zamki-na-Piasku
Warszawa - 2008 Remaster	T.Love	TLove-Warszawa
Luz - Blues, W Niebie Same Dziury	Urszula	Urszula-Luz
Jezu, jak Się Cieszę	Klaus Mitffoch	Klaus-Mitffoch-Jezu-jak-Sie-Ciesze
Naiwne pytania - 2003 Remaster	Dzem	Dzem-Naiwne-pytania
Polska	Kult	Kult-Polska
Ciern	Illusion	Illusion-Ciern
Stanie Się Tak, jak Gdyby Nigdy Nic	Voo Voo	Voo-Voo-Stanie-Sie-Tak-jak-Gdyby-Nigdy-Nic
Au Sza La La La	Shakin' Dudi	Shakin-Dudi-Au-Sza-La-La-La
Śmierć W Bikini	Republika	Republika-Smierc-W-Bikini
To Co Czujesz to Co Wiesz	Brygada Kryzys	Brygada-Kryzys-To-Co-Czujesz-to-Co-Wiesz
Idź Precz	Perfect	Perfect-Idz-Precz
Oni zaraz przyjdą tu	Breakout	Breakout-Oni-zaraz-przyjda-tu
I Nikomu Nie Wolno Się z Tego Śmiać	Kobranocka	Kobranocka-I-Nikomu-Nie-Wolno-Sie-z-Tego-Smiac
Strzeż Się Tych Miejsc	Klaus Mitffoch	Klaus-Mitffoch-Strzez-Sie-Tych-Miejsc
Pocisk miłości	T.Love	TLove-Pocisk-milosci
Koziorozec	Edyta Bartosiewicz	Edyta-Bartosiewicz-Koziorozec
Niewierzę Politykom	Tilt	Tilt-Niewierze-Politykom
Ratujmy Co Się Da	Budka Suflera	Budka-Suflera-Ratujmy-Co-Sie-Da
Mój Dom	IRA	IRA-Moj-Dom
Mass Media	TSA	TSA-Mass-Media
Kombinat	Republika	Republika-Kombinat
Zanim pójdę	Happysad	Happysad-Zanim-pojde
Dzień dobry, kocham Cię	Strachy Na Lachy	Strachy-Na-Lachy-Dzien-dobry-kocham-Cie
Czarny chleb i czarna kawa	Strachy Na Lachy	Strachy-Na-Lachy-Czarny-chleb-i-czarna-kawa
Co się z nami stało	Strachy Na Lachy	Strachy-Na-Lachy-Co-sie-z-nami-stalo
Piła tango	Strachy Na Lachy	Strachy-Na-Lachy-Pila-tango
Twoje oczy lubią mnie	Strachy Na Lachy	Strachy-Na-Lachy-Twoje-oczy-lubia-mnie
A ja żyję	Defekt Muzgó	Defekt-Muzgo-A-ja-zyje
Plamy na słońcu	Kazik Na Żywo	Kazik-Na-Zywo-Plamy-na-sloncu
Gdy nie ma dzieci	Kult	Kult-Gdy-nie-ma-dzieci
Mała Lady Punk	Lady Pank	Lady-Pank-Mala-Lady-Punk
Tańcz Głupia Tańcz	Lady Pank	Lady-Pank-Tancz-Glupia-Tancz
Ajrisz	T.Love	TLove-Ajrisz
Biała flaga - Live	Republika	Republika-Biala-flaga
Jestem z miasta - 2014	Elektryczne Gitary	Elektryczne-Gitary-Jestem-z-miasta
Przewróciło się - 2014	Elektryczne Gitary	Elektryczne-Gitary-Przewrocilo-sie
Szerokie wody - Radio Edit	Mrozu	Mrozu-Szerokie-wody
Fajnie	Maciej Maleńczuk	Maciej-Malenczuk-Fajnie
Zawsze Tam Gdzie Ty	Lady Pank	Lady-Pank-Zawsze-Tam-Gdzie-Ty
Kocham Cię, Kochanie Moje	Maanam	Maanam-Kocham-Cie-Kochanie-Moje
Dni, których nie znamy	Marek Grechuta	Marek-Grechuta-Dni-ktorych-nie-znamy
12 Groszy	Kazik	Kazik-12-Groszy
Na Co Komu Dziś	Lady Pank	Lady-Pank-Na-Co-Komu-Dzis
Serce	Kabanos	Kabanos-Serce
Goembe	Zabili Mi Żółwia	Zabili-Mi-Zolwia-Goembe
Kapslami W Niebo	Pull The Wire	Pull-The-Wire-Kapslami-W-Niebo
Mars napada	Kazik	Kazik-Mars-napada
Hit	Rafał Szatan	Rafal-Szatan-Hit
Raissa	Strachy Na Lachy	Strachy-Na-Lachy-Raissa
Malcziki	Yugoton	Yugoton-Malcziki
Buraki	Kabanos	Kabanos-Buraki
Mamo, jest mi tu dobrze	Kabanos	Kabanos-Mamo-jest-mi-tu-dobrze
Klocki	Kabanos	Kabanos-Klocki
Balony	Kabanos	Kabanos-Balony
Pancerz	Kabanos	Kabanos-Pancerz
Gruby grubas (oj tam, oj tam)	Kabanos	Kabanos-Gruby-grubas-oj-tam-oj-tam
Baleron w kartoflach pod keczupem	Kabanos	Kabanos-Baleron-w-kartoflach-pod-keczupem
Załoga G	Hurt	Hurt-Zaloga-G
Oranżada	KONIEC ŚWIATA	KONIEC-SWIATA-Oranzada
Vademecum Skauta	Lady Pank	Lady-Pank-Vademecum-Skauta
Bla, Bla, Bla	Perfect	Perfect-Bla-Bla-Bla
Koń na Białym Rycerzu	Nocny Kochanek	Nocny-Kochanek-Kon-na-Bialym-Rycerzu
Turysta (Bonus Track)	Kwiat Jabłoni	Kwiat-Jabloni-Turysta-Bonus-Track
Nienawidzę Cię Polsko!	Czesław Śpiewa	Czeslaw-Spiewa-Nienawidze-Cie-Polsko
Noś długie włosy - 2014	Elektryczne Gitary	Elektryczne-Gitary-Nos-dlugie-wlosy
Kiler	Elektryczne Gitary	Elektryczne-Gitary-Kiler
Po prostu pastelowe	Strachy Na Lachy	Strachy-Na-Lachy-Po-prostu-pastelowe
the remedy for a broken heart (why am I so in love)	XXXTENTACION	XXXTENTACION-the-remedy-for-a-broken-heart-why-am-I-so-in-love
Hero as Fool	Mr. J. Medeiros	Mr-J-Medeiros-Hero-as-Fool
J'attends - Remix	Hocus Pocus	Hocus-Pocus-Jattends
Amplifier	Imran Khan	Imran-Khan-Amplifier
Can't Feel My Face	The Weeknd	The-Weeknd-Cant-Feel-My-Face
Jocelyn Flores	XXXTENTACION	XXXTENTACION-Jocelyn-Flores
Systematic (feat. Nas)	DJ Shadow	DJ-Shadow-Systematic
Lalala	Y2K	Y2K-Lalala
Remember The Name (feat. Eminem & 50 Cent)	Ed Sheeran	Ed-Sheeran-Remember-The-Name
Phantom (Redux)	Shirt	Shirt-Phantom-Redux
The Mule	E-Vax	E-Vax-The-Mule
1977	Ana Tijoux	Ana-Tijoux-1977
bad vibes forever	XXXTENTACION	XXXTENTACION-bad-vibes-forever
Broken	Lund	Lund-Broken
Follow God	Kanye West	Kanye-West-Follow-God
HIGHEST IN THE ROOM (feat. ROSALÍA & Lil Baby) - REMIX	Travis Scott	Travis-Scott-HIGHEST-IN-THE-ROOM
IGOR'S THEME	Tyler, The Creator	Tyler-The-Creator-IGORS-THEME
C7osure (You Like)	Lil Nas X	Lil-Nas-X-C7osure-You-Like
EARFQUAKE	Tyler, The Creator	Tyler-The-Creator-EARFQUAKE
BELIEVE IT	PARTYNEXTDOOR	PARTYNEXTDOOR-BELIEVE-IT
SUGAR	BROCKHAMPTON	BROCKHAMPTON-SUGAR
Ongoing Thing	20syl	20syl-Ongoing-Thing
Rawnald Gregory Erickson the Second	STRFKR	STRFKR-Rawnald-Gregory-Erickson-the-Second
Exit Music (For a Film)	Radiohead	Radiohead-Exit-Music-For-a-Film
Help! - Remastered 2009	The Beatles	The-Beatles-Help
Way down We Go	KALEO	KALEO-Way-down-We-Go
Nobody Speak	DJ Shadow	DJ-Shadow-Nobody-Speak
Open Your Eyes	STRFKR	STRFKR-Open-Your-Eyes
Tape Machine	STRFKR	STRFKR-Tape-Machine
3.0_1-one2blame.orc	Mac Quayle	Mac-Quayle-30-1-one2blameorc
1.1_3-oneor0.wma	Mac Quayle	Mac-Quayle-11-3-oneor0wma
Freeze Me	Death From Above 1979	Death-From-Above-1979-Freeze-Me
Down The Road	C2C	C2C-Down-The-Road
Holograms	M83	M83-Holograms
Wishing Girl	Lola Marsh	Lola-Marsh-Wishing-Girl
Best Day Of My Life	American Authors	American-Authors-Best-Day-Of-My-Life
Feel It Still	Portugal. The Man	Portugal-The-Man-Feel-It-Still
Alright, Alright, Alright	Mungo Jerry	Mungo-Jerry-Alright-Alright-Alright
Man of War	Radiohead	Radiohead-Man-of-War
No Surprises	Radiohead	Radiohead-No-Surprises
Midnight City	M83	M83-Midnight-City
Bitter Sweet Symphony	The Verve	The-Verve-Bitter-Sweet-Symphony
Something Good	alt-J	alt-J-Something-Good
She Sets The City On Fire	Gavin DeGraw	Gavin-DeGraw-She-Sets-The-City-On-Fire
You Got It All... Wrong	The Hives	The-Hives-You-Got-It-All-Wrong
For the Damaged Coda	Blonde Redhead	Blonde-Redhead-For-the-Damaged-Coda
Impossible	James Arthur	James-Arthur-Impossible
Blame (feat. John Newman)	Calvin Harris	Calvin-Harris-Blame
Zombie	The Cranberries	The-Cranberries-Zombie
Do You Feel It?	Chaos Chaos	Chaos-Chaos-Do-You-Feel-It
Hurt	Johnny Cash	Johnny-Cash-Hurt
Hurt	Nine Inch Nails	Nine-Inch-Nails-Hurt
My Trigger	Miike Snow	Miike-Snow-My-Trigger
Genghis Khan	Miike Snow	Miike-Snow-Genghis-Khan
Counting Stars	OneRepublic	OneRepublic-Counting-Stars
Let Her Go	Passenger	Passenger-Let-Her-Go
Thrift Shop (feat. Wanz)	Macklemore & Ryan Lewis	Macklemore-and-Ryan-Lewis-Thrift-Shop
Afterglow	Wilkinson	Wilkinson-Afterglow
Go	The Chemical Brothers	The-Chemical-Brothers-Go
Reasons (feat. Andrew Allen)	Project 46	Project-46-Reasons
Blast from the Past	Stonebank	Stonebank-Blast-from-the-Past
Tick Tick Boom	The Hives	The-Hives-Tick-Tick-Boom
Try It Again	The Hives	The-Hives-Try-It-Again
Well All Right!	The Hives	The-Hives-Well-All-Right
Hey Little World	The Hives	The-Hives-Hey-Little-World
A Stroll Through Hive Manor Corridors	The Hives	The-Hives-A-Stroll-Through-Hive-Manor-Corridors
Won't Be Long	The Hives	The-Hives-Wont-Be-Long
T.H.E.H.I.V.E.S.	The Hives	The-Hives-THEHIVES
Return The Favour	The Hives	The-Hives-Return-The-Favour
Giddy Up!	The Hives	The-Hives-Giddy-Up
Square One Here I Come	The Hives	The-Hives-Square-One-Here-I-Come
You Dress Up For Armageddon	The Hives	The-Hives-You-Dress-Up-For-Armageddon
Puppet On A String	The Hives	The-Hives-Puppet-On-A-String
Bigger Hole To Fill	The Hives	The-Hives-Bigger-Hole-To-Fill
Go	Valley Lodge	Valley-Lodge-Go
7 Years	Lukas Graham	Lukas-Graham-7-Years
Open Your Eyes	School Of Seven Bells	School-Of-Seven-Bells-Open-Your-Eyes
Hold Me Down	Halsey	Halsey-Hold-Me-Down
Infinity	Lemmino	Lemmino-Infinity
I Need Your Love (feat. Ellie Goulding)	Calvin Harris	Calvin-Harris-I-Need-Your-Love
Intro	The xx	The-xx-Intro
Pumped Up Kicks	Foster The People	Foster-The-People-Pumped-Up-Kicks
Come And Get It	John Newman	John-Newman-Come-And-Get-It
Wonderwall	Oasis	Oasis-Wonderwall
I'm Not Having Any Fun	Bad Suns	Bad-Suns-Im-Not-Having-Any-Fun
Sucker	Vistas	Vistas-Sucker
Superblood Wolfmoon	Pearl Jam	Pearl-Jam-Superblood-Wolfmoon
Kiss With A Fist	Florence + The Machine	Florence-The-Machine-Kiss-With-A-Fist
Portland	Armors	Armors-Portland
Helicopter	Bloc Party	Bloc-Party-Helicopter
Move to San Francisco	Circa Waves	Circa-Waves-Move-to-San-Francisco
Buddy Holly	Weezer	Weezer-Buddy-Holly
Teenage Dirtbag	Wheatus	Wheatus-Teenage-Dirtbag
Kathleen	Catfish and the Bottlemen	Catfish-and-the-Bottlemen-Kathleen
if we never met	John K	John-K-if-we-never-met
Good	TWIN XL	TWIN-XL-Good
Disaster Party	MAGIC GIANT	MAGIC-GIANT-Disaster-Party
Take Me Out	Franz Ferdinand	Franz-Ferdinand-Take-Me-Out
On The 5	Winnetka Bowling League	Winnetka-Bowling-League-On-The-5
Only Happy When It Rains	Garbage	Garbage-Only-Happy-When-It-Rains
Come Thru	Zero 9:36	Zero-936-Come-Thru
Daylight	Matt and Kim	Matt-and-Kim-Daylight
Prom Queen	Beach Bunny	Beach-Bunny-Prom-Queen
Hurt Somebody	Noah Kahan	Noah-Kahan-Hurt-Somebody
The Fall	half•alive	halfalive-The-Fall
Let's Dance to Joy Division	The Wombats	The-Wombats-Lets-Dance-to-Joy-Division
Deleter	Grouplove	Grouplove-Deleter
Drops of Jupiter (Tell Me)	Train	Train-Drops-of-Jupiter-Tell-Me
how will i rest in peace if i'm buried by a highway?//	KennyHoopla	KennyHoopla-how-will-i-rest-in-peace-if-im-buried-by-a-highway
It's The End Of The World As We Know It (And I Feel Fine)	R.E.M.	REM-Its-The-End-Of-The-World-As-We-Know-It-And-I-Feel-Fine
I've Got a Woman	Ray Charles	Ray-Charles-Ive-Got-a-Woman
Shout, Pts. 1 & 2	The Isley Brothers	The-Isley-Brothers-Shout-Pts-1-and-2
Try A Little Tenderness	Otis Redding	Otis-Redding-Try-A-Little-Tenderness
I Heard It Through The Grapevine	Marvin Gaye	Marvin-Gaye-I-Heard-It-Through-The-Grapevine
I Want You Back	The Jackson 5	The-Jackson-5-I-Want-You-Back
Respect	Aretha Franklin	Aretha-Franklin-Respect
Land of 1000 Dances	Wilson Pickett	Wilson-Pickett-Land-of-1000-Dances
I Say a Little Prayer	Aretha Franklin	Aretha-Franklin-I-Say-a-Little-Prayer
Signed, Sealed, Delivered (I'm Yours)	Stevie Wonder	Stevie-Wonder-Signed-Sealed-Delivered-Im-Yours
Ain't No Sunshine	Bill Withers	Bill-Withers-Aint-No-Sunshine
Sir Duke	Stevie Wonder	Stevie-Wonder-Sir-Duke
Mess Around	Ray Charles	Ray-Charles-Mess-Around
On & On	Erykah Badu	Erykah-Badu-On-and-On
Everything's Gonna Be Alright (feat. BJ the Chicago Kid & The Hamiltones)	PJ Morton	PJ-Morton-Everythings-Gonna-Be-Alright
The Bird	Anderson .Paak	Anderson-Paak-The-Bird
Time Alone With You (feat. Daniel Caesar)	Jacob Collier	Jacob-Collier-Time-Alone-With-You
Turnin' Me Up	BJ The Chicago Kid	BJ-The-Chicago-Kid-Turnin-Me-Up
Religion	PJ Morton	PJ-Morton-Religion
Melanin Man (feat. Masego)	Brasstracks	Brasstracks-Melanin-Man
Distance	Emily King	Emily-King-Distance
Chanel	Frank Ocean	Frank-Ocean-Chanel
The Heartburn Song	Lawrence	Lawrence-The-Heartburn-Song
Teach You	Emily King	Emily-King-Teach-You
Make Me Feel	Janelle Monáe	Janelle-Monae-Make-Me-Feel
Bohemian Rhapsody - 2011 Mix	Queen	Queen-Bohemian-Rhapsody
Rocket Man (I Think It's Going To Be A Long, Long Time)	Elton John	Elton-John-Rocket-Man-I-Think-Its-Going-To-Be-A-Long-Long-Time
Welcome To The Jungle	Guns N' Roses	Guns-N-Roses-Welcome-To-The-Jungle
Summer Of '69	Bryan Adams	Bryan-Adams-Summer-Of-69
Billie Jean	Michael Jackson	Michael-Jackson-Billie-Jean
(You Make Me Feel Like) A Natural Woman	Aretha Franklin	Aretha-Franklin-You-Make-Me-Feel-Like-A-Natural-Woman
Escape (The Pina Colada Song)	Rupert Holmes	Rupert-Holmes-Escape-The-Pina-Colada-Song
Gimme Shelter	The Rolling Stones	The-Rolling-Stones-Gimme-Shelter
Paint It, Black	The Rolling Stones	The-Rolling-Stones-Paint-It-Black
Uptown Girl	Billy Joel	Billy-Joel-Uptown-Girl
As Tears Go By - Mono Version	The Rolling Stones	The-Rolling-Stones-As-Tears-Go-By
Don't Stop Believin'	Journey	Journey-Dont-Stop-Believin
Jessie's Girl	Rick Springfield	Rick-Springfield-Jessies-Girl
September	Earth, Wind & Fire	Earth-Wind-and-Fire-September
Livin' On A Prayer	Bon Jovi	Bon-Jovi-Livin-On-A-Prayer
Sweet Caroline	Neil Diamond	Neil-Diamond-Sweet-Caroline
I Wanna Dance with Somebody (Who Loves Me)	Whitney Houston	Whitney-Houston-I-Wanna-Dance-with-Somebody-Who-Loves-Me
Eye of the Tiger	Survivor	Survivor-Eye-of-the-Tiger
Fast Car	Tracy Chapman	Tracy-Chapman-Fast-Car
Ain't No Mountain High Enough	Marvin Gaye	Marvin-Gaye-Aint-No-Mountain-High-Enough
Any Way You Want It	Journey	Journey-Any-Way-You-Want-It
Brown Eyed Girl	Van Morrison	Van-Morrison-Brown-Eyed-Girl
Tiny Dancer	Elton John	Elton-John-Tiny-Dancer
Born in the U.S.A.	Bruce Springsteen	Bruce-Springsteen-Born-in-the-USA
American Pie	Don McLean	Don-McLean-American-Pie
Isn't She Lovely	Stevie Wonder	Stevie-Wonder-Isnt-She-Lovely
American Girl	Tom Petty and the Heartbreakers	Tom-Petty-and-the-Heartbreakers-American-Girl
Sweet Thing - 1999 Remaster	Van Morrison	Van-Morrison-Sweet-Thing
Live And Let Die	Paul McCartney	Paul-McCartney-Live-And-Let-Die
Piano Man	Billy Joel	Billy-Joel-Piano-Man
P.Y.T. (Pretty Young Thing)	Michael Jackson	Michael-Jackson-PYT-Pretty-Young-Thing
Hotel California - 2013 Remaster	Eagles	Eagles-Hotel-California
Sweet Pea	Amos Lee	Amos-Lee-Sweet-Pea
Cigarette Daydreams	Cage The Elephant	Cage-The-Elephant-Cigarette-Daydreams
Carry on Wayward Son	Kansas	Kansas-Carry-on-Wayward-Son
Dancing Queen	ABBA	ABBA-Dancing-Queen
Come Dancing	The Kinks	The-Kinks-Come-Dancing
Pictures Of You	The Last Goodnight	The-Last-Goodnight-Pictures-Of-You
Let It Be - Remastered 2009	The Beatles	The-Beatles-Let-It-Be
Sweet Child O' Mine	Guns N' Roses	Guns-N-Roses-Sweet-Child-O-Mine
Dancing in the Moonlight	Toploader	Toploader-Dancing-in-the-Moonlight
Dream On	Aerosmith	Aerosmith-Dream-On
Born to Run	Bruce Springsteen	Bruce-Springsteen-Born-to-Run
Margaritaville	Jimmy Buffett	Jimmy-Buffett-Margaritaville
Take on Me	a-ha	a-ha-Take-on-Me
Imagine - Remastered 2010	John Lennon	John-Lennon-Imagine
Wanted Dead Or Alive	Bon Jovi	Bon-Jovi-Wanted-Dead-Or-Alive
Free Fallin'	Tom Petty	Tom-Petty-Free-Fallin
The Boys Are Back In Town	Thin Lizzy	Thin-Lizzy-The-Boys-Are-Back-In-Town
Take Me Home, Country Roads - Rerecorded	John Denver	John-Denver-Take-Me-Home-Country-Roads
Opportunities (Let's Make Lots of Money) - 2018 Remaster	Pet Shop Boys	Pet-Shop-Boys-Opportunities-Lets-Make-Lots-of-Money
Starman - 2012 Remaster	David Bowie	David-Bowie-Starman
Candle In The Wind - Remastered 2014	Elton John	Elton-John-Candle-In-The-Wind
Jolene (feat. Dolly Parton)	Pentatonix	Pentatonix-Jolene
Sweet Home Alabama	Lynyrd Skynyrd	Lynyrd-Skynyrd-Sweet-Home-Alabama
Stayin' Alive	Bee Gees	Bee-Gees-Stayin-Alive
You're The One That I Want - From “Grease”	John Travolta	John-Travolta-Youre-The-One-That-I-Want
Highway to Hell	AC/DC	AC-DC-Highway-to-Hell
Africa	TOTO	TOTO-Africa
Thriller	Michael Jackson	Michael-Jackson-Thriller
Never Gonna Give You Up	Rick Astley	Rick-Astley-Never-Gonna-Give-You-Up
Smells Like Teen Spirit	Nirvana	Nirvana-Smells-Like-Teen-Spirit
Come On Eileen	Dexys Midnight Runners	Dexys-Midnight-Runners-Come-On-Eileen
Everybody Wants To Rule The World	Tears For Fears	Tears-For-Fears-Everybody-Wants-To-Rule-The-World
Here Comes The Sun - Remastered 2009	The Beatles	The-Beatles-Here-Comes-The-Sun
I'm Gonna Be (500 Miles)	The Proclaimers	The-Proclaimers-Im-Gonna-Be-500-Miles
Hey Jude - Remastered 2015	The Beatles	The-Beatles-Hey-Jude
Wake Me up Before You Go-Go	Wham!	Wham-Wake-Me-up-Before-You-Go-Go
Stayin' Alive - From "Saturday Night Fever" Soundtrack	Bee Gees	Bee-Gees-Stayin-Alive
Lean on Me	Bill Withers	Bill-Withers-Lean-on-Me
You Give Love A Bad Name	Bon Jovi	Bon-Jovi-You-Give-Love-A-Bad-Name
Walking On Sunshine	Katrina & The Waves	Katrina-and-The-Waves-Walking-On-Sunshine
Life is a Highway	Rascal Flatts	Rascal-Flatts-Life-is-a-Highway
Red Solo Cup	Toby Keith	Toby-Keith-Red-Solo-Cup
Shot Through The Heart	Bon Jovi	Bon-Jovi-Shot-Through-The-Heart
We Built This City	Starship	Starship-We-Built-This-City
Jump - 2015 Remaster	Van Halen	Van-Halen-Jump
Don't Go Breaking My Heart	Backstreet Boys	Backstreet-Boys-Dont-Go-Breaking-My-Heart
She's Kerosene	The Interrupters	The-Interrupters-Shes-Kerosene
The Longest Time	Billy Joel	Billy-Joel-The-Longest-Time
You Can’t Always Get What You Want - Live	The Rolling Stones	The-Rolling-Stones-You-Cant-Always-Get-What-You-Want
Feeling Good	Nina Simone	Nina-Simone-Feeling-Good
Hard to Handle - Live at Fillmore East, New York City, April 1971	Grateful Dead	Grateful-Dead-Hard-to-Handle
Hard To Handle	The Black Crowes	The-Black-Crowes-Hard-To-Handle
Ice Ice Baby	Vanilla Ice	Vanilla-Ice-Ice-Ice-Baby
The Time Warp	Reeve Carney	Reeve-Carney-The-Time-Warp
Only the Good Die Young	Billy Joel	Billy-Joel-Only-the-Good-Die-Young
Hey Jude	The Beatles	The-Beatles-Hey-Jude
In the End	Linkin Park	Linkin-Park-In-the-End
Pour Some Sugar On Me - Remastered 2017	Def Leppard	Def-Leppard-Pour-Some-Sugar-On-Me
Time Warp	Little Nell	Little-Nell-Time-Warp
Dirty Little Secret	The All-American Rejects	The-All-American-Rejects-Dirty-Little-Secret
